56
81
songs/GrassyWalks.wav
100
S-Planes of Paris I
E-firstOne
E-OGteste
P1
---------------------------------------------------------------------------------
---------------------------------------------------------------------------------
---------------------------------------------------------------------------------
---------------------------------------------------------------------------------
---------------------------------------------------------------------------------
---------------------------------------------------------------------------------
---------------------------------------------------------------------------------
---------------------------------------------------------------------------------
----------------------------------------------GGGGGGG----------------------------
---------------------------------------------------------------------------------
---------------------------------------------------------------------------------
---------------------------------------------------------------------------------
-----------------------------------------GGGGG-----------------------------------
-------------------GGGGGGGGGGG---------------------------------------------------
---------------------------------------------------------------------------------
----------------------------------------------------D2-D2PpD2D2------------------
------------------------------------------------GD2D--D--------------------------
----------------------------------GGGGGGG-----GGD--D2D2D2---D2D2D2---------------
------GGGGG----------------------------------GD2DDD--------D------D--------------
-------------------------------------------GGD--D2D--------------D2--------------
----------------------------GGG-----------GD2D2D-------------------D-------------
------------------------GGGGD2DGGGG------GD--------------D--------DD2------------
-----------------------GD2DD--D2D2DGGGGGGDD2-------------D-----------D2----------
-------------GGGGG---GGD--D2------D2D2D2D2---------------DDD-------D2------------
---------------------D2D2----------------------------------D---------DD2D2-------
-------------------------------D2--------------------D-----D--------------D------
----------------------D2-----------------------------D-------------------DD2-----
--------------------GD---------D2--------------------DDD-------------------------
-------GGGG--------GDD2-----------------------D---------------------------D2-----
------------------GDD----------D2D2-----------DDD--------------------------------
--------------DDDDDD2--------------DD----------D--------------DD---------D2D-----
--------------(Kp0)----------------------DD--------D-------------D-------------D2----
-----------------------------------------------DDD-----------D-----------D2------
------GGGGGGGGGG------DD-------------------------DD------------------------D-----
------------D2DD-------D-----D--------------------------------------D-----D2D2---
--------------D2D------------D--------------------------------------D---------GGG
------------D2-------------DD-------------------------D2----------DDD----D2D2----
----------F--------D------D-------D----------------------------------------------
------------D2-----D------D-------D------------------D2DD2----------------D2-----
----------D2------DDDD--------------------------------------------------D2-------
----------------------------------------D------------D2--DD2--------------D------
----------DD2-----------DDDD-----------DD------D2--D2-------D---------D2D--------
---------DD----------------------------D------------------D2DD2-----D2-----------
--------D2F--------------------------DDD-----------(Kr0)--------D--DD2----D----------
----------------------------------------------------------D2-D2D--D2D------------
--------DDDD2DD2DD-----------------------------D2D2DD2D2D2-------D---------------
---------D2--D--D2D---D2----DD---------------D2----D-----------------------------
-----------DD2----D2D--------------------------DDD2D2----------------------------
------DDDDDD-----D--D2D2D2------------D2D2--D2DD2--------------------------------
-------------------D------D--D2-----------D2--D----------------------------------
------------------------DD2D2-------DD2DD2---------------------------------------
-----------------------------DD-----D--D--D2-------------------------------------
-----------------------------D2-----(Kw0)----N---------------------------------------
------------------------------------------D2-------------------------------------
------------------------------DD2ADD2DD2D2---------------------------------------
---------------------------------DD--D----D--------------------------------------
P2
---------------------------------------------------------------------------------
---------------------------------------------------------------------------------
---------------------------------------------------------------------------------
---------------------------------------------------------------------------------
---------------------------------------------------------------------------------
---------------------------------------------------------------------------------
---------------------------------------------------------------------------------
---------------------------------------------------------------------------------
---------------------------------------------------------------------------------
------------------------------------------------DD2------------------------------
------------------------------------------------D--------------------------------
------------------------------------------------D2D------------------------------
--------------------------------------------------D------------------------------
-------------------------------------------D----DD2------------------------------
--------------------D2-----D2--------------D----D--------------------------------
-------------------------------------------D----DDD------D2----------------------
--------------------D2-----D2--------------D-------------------------------------
-------------------------------------------D-------------D2D---------------------
--------------------D2-----D2-------DDD----D-------------------------------------
-------DD2--------------------------DDD------------D2D2DD2D2DD2D2----------------
-------D------------D2-----D--------DDD-----------D----D----D--------------------
-------D2D--------------------------DDD--------D2D2D2D2D2-D2DDDDD2---------------
---------D----------DD----------------------D2D-------------D2D2--DD-------------
-------DD2----------D-------D2----------------DDDDD2D2DD2-------DD2--------------
-------D------DD2---D----D----DDDD--------DD2D2D2D----D--D2-DDDDD----------------
-------D2D----D-----D----DDD2DD--DDDD2DD2DD------DDDD-D2D---D2D2D2D2D2-----------
---------D----D2D---DD--DD2--D2--D2D--D--D2D2D2DDD2D2---DDD2----------DD2--------
-------DDD------D-------D--DD------DDDD2D------D2-------D2--D2DDD2D2DD2--D-------
--------------DD2------DD2D2D2D--DDD2D--D2D2D2---D2DDDD2--DD--D2----D--DD2-------
-------DD2----D--------D------D------D2D-----------DD2--DDD2D2--DDDDDDD2---------
-------D-------------DDDDD2D2D2--------D2DDDDD2-D2DD--DDD2------D2DD2D--D--------
-------DD2-----DDD2--DD2D------D2D2D2----D2D2-----D2D2D2--DD2-D2--D--DD2D--------
-------D-------DD--DD2--DDDD2D2------D2D2----D2---------DD2-----D2DD2D--D-----DDD
----------------DDD2----D2D----DD2D2D----DD2D--D2--D2DDDD--DDD2D--D--D2DD-----DBD
------D---------DD--DD2---DD2-D2----D2D2DD--DDD--D2--D2D2DD2D--DD2D2---D2D----DDD
------D----------DD2D--D2D2-----D2D2----D2DD2DD2D--DD----D--DDDD-----D2--D-------
------D---------DD--DDD------D2D----DDDD--D--D--DD2DD2--D2DDD2D2D2-----D2--------
------D-------D2DD2-D2DDD2-DD--DD2-D2DD2DDD2DD2D2--D------D2------D2D2D----------
------D---------D-----D2---DD2D2-----D--D2--D----D2D2-------DDD2DD----D2DD-------
------D-------DDD2------D2D2----DD2D2DD2--DD2D2D2------D--DDD2--D2DDDD-----------
------D-----DDD2--D2D2D2----D2DD2----D---D2------D2DD--D2-----D2--D2D2DD---------
------D------D--DD------------D--DDDDD2----DDD2----------D---D--D2---------------
------D------DDDDDDDDD2D2D2D2DDDDD2D2---D2DD2----D2--DDDD2-----D--D2-------------
------D---DD2DD2D2D2D--------DD2D---------D--D2D2---D2DB-------------------------
------D---D--D------D2D2DDDDD2--DDDDD2D2DD2DD----DD---DDDD-----------------------
------D-----------DD----D2D2--D2D2D2----D--D2DD----------------------------------
------D------------DDD--------------D2D2D2D--------------------------------------
------D--------------D--DDD2D2D2D2D2------D2DD-----------------------------------
------------------------------------D2-------------------------------------------
---------------------------DD--DDD2D---------------------------------------------
-------------------------------DD--D---------------------------------------------
-------------------------------DD2D2---------------------------------------------
-------------------------------D-----DD2D2---------------------------------------
-------------------------------DDDDD-D-------------------------------------------
---------------------------------------------------------------------------------
---------------------------------------------------------------------------------
P3
---------------------------------------------------------------------------------
-------------------------------------------------(Fp)-------------------------------
-------------------------------------------------(Fp)-------------------------------
-------------------------------------------------(Fp)-------------------------------
-------------------------------------------------(Fp)-------------------------------
-------------------------------------------------(Fp)-------------------------------
----------------------------------------------(Cc)--(Fp)--(Cc)----------------------------
----------------------------------------------(Cc)--(Fp)--(Cc)----------------------------
---------------------------------------------------------------------------------
---------------------------------------------------------------------------------
---------------------------------------------------------------------------------
-------------------(Cc)(Fc)(Fw)(Fc)(Fw)(Fc)(Fw)(Fc)(Fw)(Fc)(Cc)---------------------------------------------------
-------------------(Cc)(Fc)(Fw)(Fc)(Fw)(Fc)(Fw)(Fc)(Fw)(Fc)(Cc)---------------------------------------------------
---------------------------------------------------------------------------------
---------------------------------------------------------------------------------
----------------------------------(Cc)(Fh)(Fp)(Fh)(Fp)(Fh)(Cc)----------------------------------------
------(Cc)(Fr)(Fr)(Fr)(Cc)-----------------------(Cc)(Fh)(Fp)(Fp)(Fp)(Fh)(Cc)----------------------------------------
------(Cc)(Fr)(Fr)(Fr)(Cc)----------------------------------------------------------------------
---------------------------------------------------------------------------------
---------------------------------------------------------------------------------
------------------------------------------------------------(Fh)--------------------
-------------(Cc)(Fp)(Fp)(Fp)(Cc)-----------------------------------(Cc)---------------------------
-------------(Cc)(Fp)(Fp)(Fp)(Cc)-----------------------------------(Cc)---------------------------
-----------------------------------------------------(Cc)------(Fw)(Fw)(Fw)(Fw)-----------------
----------------------------------------------(Cc)------(Cp)-(Fh)----(Fw)-(Kw)(Fw)-----------------
----------------------------------------------(Cc)-------------(Fw)(Fw)(Fw)(Fw)-----------------
-------(Cc)(Fh)(Fh)(Cc)-----------------------------------(Cc)----------------------------------
-------(Cc)(Fh)(Fh)(Cc)----------------(Fh)-----(Fp)------------(Cp)---(Fh)----------(Cc)-------------------
---------------------------------(Fp)(Fp)--------------------------(Cc)---(Fh)---------------
-----------------------------(Fh)-----(Fp)(Fp)------------------------(Cc)-------------------
--------------------------(Fh)--(Fh)-------(Fp)(Fp)----------------(Fh)-----(Cp)------(Cc)---(Fh)--------
-(Fc)(Fc)(Fc)-------------------------(Fh)--------------------------------------(Cc)------------
-(Fc)(Kp)(Fc)---------------(Fc)--(Fw)(Fw)-----(Fh)----(Fr)---------------------------------(Cc)---------(Fr)(Fr)(Fr)
-(Fc)(Fc)(Fc)---------------(Fc)---------(Fh)----(Fr)---------------------------------(Cp)---------(Fr)(Kr)(Fr)
-------------------(Fc)--------------(Fr)----(Fh)--------------------------------------(Fr)(Fr)(Fr)
-------------------(Fc)--------------(Fr)--------------------------(Fh)-------------------
-------------------(Fc)----------(Fh)---(Fr)------------(Fh)---------------------------------
--------(Cg)------------------------------------------------------------------------
------------------(Fw)-(Fw)(Fw)-----------------------------------------------------------
----------------------------------------(Cp)--------------(Fc)------------(Fh)------------
----------------(Fh)-------(Fp)(Fp)(Fp)(Fp)-----------(Fc)-------(Fw)(Fw)------(Fr)(Fp)------------------------
-----------------------(Fp)----(Fp)--------------------------(Fw)(Fc)(Fp)-----------------------
--------------------(Fh)---(Fp)(Fp)(Fp)(Fp)---------(Fc)(Fc)--------------(Fp)(Fh)(Fh)(Fh)(Fr)-----------------------
---------------------------------(Fh)------------------(Fw)(Fw)(Fh)(Pw)(Fh)(Fw)-----------------------
-------------------------------------------(Fh)--------(Fr)(Fc)(Fh)(Fh)(Fh)(Fp)-----------------------
-----------------------------(Cp)---------------------------------------------------
---------------------------------------------------------------------------------
---------------------------------------------------------------------------------
---------------------------------------------------------------------------------
---------------------------------------------------------------------------------
---------------------------------------------------------------------------------
---------------------------------------------------------------------------------
---------------------------------------------------------------------------------
---------------------------------------------------------------------------------
---------------------------------------------------------------------------------
---------------------------------------------------------------------------------
P4
18-15-"bee"
23-9-"bee"
28-13-"bee"
16-24-"bee"
14-32-"bee"
15-43-"bee"
11-42-"bee"
10-57-"bee"
4-49-"butterfly"
14-37-"butterfly"
9-24-"butterfly"
14-8-"butterfly"
49-33-"meldrop"
38-65-"meldrop"
24-61-"meldrop"
33-64-"bee"
30-42-"bee"
37-38-"butterfly"
31-52-"butterfly"
26-64-"butterfly"
27-23-"snail"
28-68-"snail"
16-37-"snail"
40-9-"snail"
endmap