37
172
songs/MainTheme.wav
150
S-ButterCave
E-continuityTest
E-firstOne
P1
----------------------------------------------------------------------------------------------------------------------------------------------------------------------------
--------------------------------------------------D---------------------GGG-------------------------------------------------------------------------------------------------
--------------------------------------------------D---------------------DDD-------------------------------------------------------------------------------------------------
---DDDDDDDDDDDDDDDDDDDDDDDDDDDDDDDDDD-------------D---------------------DDD------------------------------GGGGGGGGGGGG-------------------------------------------------------
---D-D-D---D--D--D--DD--D----------D2--------G----D-------------------------------------------------------DDD2D2D2D---------------------------------------------------------
---D-D-----D-----D---D--D-------------------------D-------------------------------------------------------------------------------------------------G---G-------------------
---D--------------------D--------GGD2-------------DGGGGG-------------------------------GGGGGGGGGGGGGG---------DD-----------------------------------GDGGGDGPpGGGGGG----------
-D2D--------------------D----------------G--------D----------GGGGGGG--------------------DD2D2D2D2DD-------------------------------------------------DDDDDD--DDDDD-----------
---D--------------------DGG-----------------------D-----------DDDDD----------------------------------------------------------------------------------(Kh0)--------D-------------
---F--------------------D-----------------------GGD------------DD-------------------------DD--D---------------------------------------------------------------D-------------
---------------GGGG----D2--------GGD2-------------D-------------D--------------------------D-------------------------DDDD----------------------------DDDDD--DD--------------
-D2DGG------G-------------------------------------(Kh0)----------------------------------------(S2)--------------------------DD----------------------------------DD----------------
---D--------D-----------D----------D2---------------------------------------------------------------------------------------------------(S0)--(S0)--------------------------------
---DGGPpGGG-D--------G--D-------GGG-----------GGGGD------------------D------------------------------------------------------------------GPpG--------------------------------
---D--------D--------D--D----------D2-------------D------------------D------------------------------------------------------------------------------------------------------
---D--------D------GGD--D-------------------------D------------------D---------------------------------------------------------G--------------------------------------------
---D-------GDGG------D2D2------GGGGD2-------------D------------------D---D----------------------------------------GG--------------------------------------------------------
---D-----------------------------------(S0)-(S0)--------DG---------D-------D---D--------------------------------------------------------------------------------------------------
---DGGG----------------------------D2D2D2D2D2--D2D2DGG-------D-------D---D-----------GGGGGGGG-------------------------------------------------------------------------------
---D--------GG----------------GGGGG--------------------------D----D--D---D---------GGDDDDDDDDG------------------------------------------------------------------------------
---D------------G-----D2-----------D2-------------D----------D----D--D---D-D(S0)(S0)(S0)(S0)GGGDDDDDDDDDDDGG----------------------------------------------------------------------------
---D-----D-----GD---------------------------------DGG--GGGGGGGGGGGGGGGGGGGGGGGGGDDDDDDDDDDDDDDDDGGG-G---GGG-----------DD----------------------------------------------------
---D---D2D-----D2-----D2-----------D2--GGGGGGGGGGGGD2--D2D2D2D2D2D-----D2D2D2D2D2D2--D2D2D2D2D2D2D2-D2--DDD-----------------------------------------------------------------
---GGAG--DDGGGG--GGGGG--GGGGGGGGGGG---------------D-----------------------------------------------------DDD------D-------------------GGGG-----------------------------------
---D2D2D2D2D2D2D2D2D2D2D2D2D2----D2D2-------------DD2------------------D2D2D2D2D2----D2D2D2D2D2D2D2-D2--DDD------D--------------------DD2-----------------------------------
-------------------------------------GG-GG--G--G--G----------------GGGG---------------------------------DDD-----DD-------------------------------------GGGGGGGGGGGGGGGGGGGG-
---D2D2D2D2D2D2D2D2D2D2D2D2D2--D2D2D2----------------------GGGGGGGGD2D2D2D2D2D2--------D2D2D2D2D2D2-D2--DDD----DDD------GGGG-----------DD--------------D2D2D2D2D2D2D2D2D2D2-
------------------------------(S1)------GGGG---------------GGGDDDDDDDD-------------------------------------DDD---DDDD-----(S1)DDDD(S3)----------DD-----------------------------------
---D(S3)---------------(S2)(S2)(S2)(S2)(S2)------D--------------------------(S2)(S2)(S2)(S2)(S2)(S2)(S2)-------------------------DDDDDDD---D2--DDD------------(S1)DDDD(S3)----------DD--------------(S2)(S2)(S2)(S2)(S2)(S2)(S2)(S2)(S2)(S2)(S2)(S2)(S2)(S2)(S2)(S2)(S2)DD--
---D(S3)-------------------------DD--------------------------------------------------------------------------------DD-----(S1)DDDD(S3)---------------------------------------D2D2D2--
---D(S3)-----DDDDD---------------D---------------------------------------------------------------------------------DD-----(S1)DDDD(S3)-----------------------------------------------
---D(S3)-----DDDD------------------------(S0)(S0)(S0)(S0)(S0)(S0)G-GGG--GG-----------GGGGG(S0)(S0)(S0)(S0)--------------GGGGG---------------------D---------------------DD---------------------------(Kw0)--ND2--
---DDD-----DDD------------DD---------D2D2D2D2D2D2D2D2G--------(S1)DDDDDDDDDDGGGGG---------F----G-------D2-----------D--------------------(S1)DD-----(S0)(S0)------------(S0)(S0)(S0)(S0)------------
----DD-----------(S0)(S0)(S0)(S0)(S0)DDDD----------D----------------DG-------(S1)DDDDDDDDDDDDDD----------------G--------------------------DDDD----------(S1)DD-----GGGGGGGGGGGGGGGGGGGGGGGGGGD2--
-----DD(S0)(S0)--------DDDDD---------------DDD2D2D2D2D2DDD----------(S1)DD--------------------GGGGGGGG-------D2-----------------(S1)DDDD(S3)---------(S1)DD-----D2D2D2D2D2D2D2D2D2D2D2D2D2----
------DDDDDDDDDDD-----------------------------------------------------------------------DDD----------------------D-----(S1)DDDD(S3)---------(S1)DD-------------------------------D---
----------------------------------------------------------------------------------------------------------------------------------------------------------------------------
P2
----------------------------------------------------------------------------------------------------------------------------------------------------------------------------
----------------------------------------------------------------------------------------------------------------------------------------------------------------------------
----------------------------------------------------------------------------------------------------------------------------------------------------------------------------
----------------------------------------------------------------------------------------------------------------------------------------------------------------------------
----------------------------------------------------------------------------------------------------------------------------------------------------------------------------
----------------------------------------------------------------------------------------------------------------------------------------------------------------------------
----------------------------------------------------------------------------------------------------------------------------------------------------------D2----------------
----------------------------------------------------------------------------------------------------------------------------------------------------------------------------
----D-------------------------------------------------------------------------------------------------------------------------------------------------D2D2D2D2--------------
-D2DD-----------------------------------------------------------------------------------------------------------------------------------------------------------------------
---DDD----------------------------------------------------------------------------------------------------------------------------------------------------DD----------------
----------------------------------------------------------------------------------------------------------------------------------------------------------------------------
----------------------------------------------------------------------------------------------------------------------------------------------------------------------------
----------------------------------------------------------------------------------------------------------------------------------------------------------------------------
----------------------------------------------------------------------------------------------------------------------------------------------------------------------------
----------------------------------------------------------------------------------------------------------------------------------------------------------------------------
----------------------------------------------------------------------------------------------------------------------------------------------------------------------------
----------------------------------------------------------------------------------------------------------------------------------------------------------------------------
----------------------------------------------------------------------------------------------------------------------------------------------------------------------------
----------------------------------------------------------------------------------------------------------------------------------------------------------------------------
----------------------------------------------------------------------------------------------------------------------------------------------------------------------------
----------------------------------------------------------------------------------------------------------------------------------------------------------------------------
----------------------------------------------------------------------------------------------------------------------------------------------------------------------------
----------------------------------------------------------------------------------------------------------------------------------------------------------------------------
----------------------------------------------------------------------------------------------------------------------------------------------------------------------------
----------------------------------------------------------------------------------------------------------------------------------------------------------------------------
----------------------------------------------------------------------------------------------------------------------------------------------------------------------------
----------------------------------------------------------------------------------------------------------------------------------------------------------------------------
----------------------------------------------------------------------------------------------------------------DD-----------------------------------------DDDDDDDDDDDDD----
---------------------------------------------------------------------------------------------------------------------------------------DD------------------D2D2D2DD2--------
----------------------------------------------------------------------------------------------------DD---------------------------------DD------------------------D----------
----------------------------------------------------------------------------------------------------DD------------------DDDD-------------------------------D2D2DDD2D-DD2----
------------------------------------------------------------------------------------------------------------------------DDDD-----------------------------------DD--D-D------
-----------------------------------------------------------------------------------------------------------------D----------------------------------------------------------
-----------------------------------------------------------------------------------------------------------------D----------------------------------------------------------
----------------------------------------------------------------------------------------------------------------------------------------------------------------------------
----------------------------------------------------------------------------------------------------------------------------------------------------------------------------
P3
----------------------------------------------------------------------------------------------------------------------------------------------------------------------------
---(Sh)------------------------------------------------------------------------------------------------------------------------------------------------------------------------
----------------------(Fh)-----------------------------------------------------------------------------------------------------------------------------------------------------
---------------------------------------------(Fh)------------------------------------------------------------------------------------------------------------------------------
----------------------(Cc)-----------(Cc)----------------------------------------------------------(Cg)------------------------------------------------------------------------------
----------------------------------------------------------------------------------------------------------------------------------------------------------------------------
-----------------------------------------(Fr)----------------------------------------------------------------------------------------------------------------------------------
----------------------------------------------------------------------------------------------------------------------------------------------------------------------------
-------------------------------------------------------------------------------------------------------------------------------------------------------------(Kw)--------------
-------------------------------------------------------------------------------------------------------------------------------------------------------(Sf)--------------------
----------------------------------------------------------------------------------------------------------------------------------------------------------------------------
-------------------------------------------------------------------------------------------------------------------------------(Fw)--------------------------------------------
----------------------------------------------------------------------------------------------------------------------------------------------------------------------------
-----------(Cc)----------------------------------------------------------------------------------------------------------------------------------------------------------------
----------------------------------------------------------------------------------------------------------------------------------------------------------------------------
----------------------(Cp)-----------------------------------------------------------------------------------------------------------------------------------------------------
----------------------------------------------------------------------------------------------------------------------------------------------------------------------------
----------------------------------------------------------------------------------------------------------------------------------------------------------------------------
----------------------------------------------------------------------------------------------------------------------------------------------------------------------------
----------------------------------------------------------------------------------------------------------------------------------------------------------------------------
---------------------------------------------------------------------------------------------------------(Fp)------------------------------------------------------------------
----(Fh)-----------------------------------------------------------------------------------------------------------------------------------------------------------------------
--------------------------------------------------------------------(Cc)------------------------------------------------------------------(Fh)(Kh)-----------------------------------
----------------------------------------------------------------------------------------------------------------------------------------------------------------------------
-------------------------------(Se)------------(Fh)--(Fr)---------------------------------------------------------------(Fh)------------------------------------------------------------
-------------------------------(Cp)(Fh)-----------------------------------------------------------------------------------------(Fp)-------------------------------------------------
--------------------------------------------------------(Fc)-------------------------------------------------------------------------------------------------------------------
----------------------------------------------------------------------------------------------------------------------------------------------------------------------------
----------------------------------------------------------------------------------------------------------------------------------------------------------------------------
----------------------------------------------------------------------------------------------------------------------------------------------------------------------------
----------------------------------------------------------------------------------------------------------------------------------------------------------------------------
----------------------------------------------------------------------------------------------------------------------------------------------------------------------------
----------------------------------------------------------------------------------------------------------------------------------------------------------------------------
-------------------------------------------------------------------------------------------------------------(Sw)--------------------------------------------------------------
----------------------------------------------------------------------------------------------------------------------------------------------------------------------------
-----------------------------------------------------------------------(Kh)----------------------------------------------------------------------------------------------------
----------------------------------------------------------------------------------------------------------------------------------------------------------------------------
P4
11-48-"bee"
11-20-"bee"
21-38-"bee"
16-80-"bee"
27-84-"bee"
14-89-"butterfly"
5-85-"butterfly"
8-155-"meldrop"
endmap