27
166
P1
----------------------------------------------------------------------------------------------------------------------------------------------------------------------
----------------------------------------------------------------------------------------------------------------------------------------------------------------------
DDDDDDDDDDDDDDDDDDDDDDDDDDDDDDDDDD-------------D------------------------------------------------------GGGGGGGGGGGG----------------------------------------------------
D-D-D---D--D--D--DD--D----------D2--------G----D-------------------------------------------------------DDD2D2D2D------------------------------------------------------
D-D-----D-----D---D--D----------||-------------DGGGGG----------------------------------------------------||||||-------------------------------------------------------
D--------------------D--------GGD2-------------D------------------------------------GGGGGGGGGGGGGG---------DD---------------------------------------------------------
D--------------------D----------||----G--------D----------GGGGGGG--------------------DD2D2D2D2DD----------------------------------------------------------------------
D---F----------------DGG-----------------------D-----------DDDDD----------------------||||||||------------------------------------------------------------------------
D--------------------D-----------------------GGD------------DD-------------------------DD--D--------------------------------------------------------------------------
D-----------GGGG----D2--------GGD2-------------D-------------D--------------------------D-----------------------------------------------------------------------------
DGG------G----------------------||------------------------------------------------------------------------------------------------------------------------------------
D--------D-----------D----------D2------------------------------------------------------------------------------------------------------------------------------------
D----GGG-D--------G--D-------GGG||---------GGGGD------------------D---------------------------------------------------------------------------------------------------
D--------D--------D--D----------D2-------------D------------------D---------------------------------------------------------------------------------------------------
D--------D------GGD--D----------||-------------D------------------D---------------------------------------------------------G-----------------------------------------
D-------GDGG------D2D2------GGGGD2-------------D------------------D---D----------------------------------------GG-----------------------------------------------------
D-----------------||||----------||-------------D----------D-------D---D-----------------------------------------------------------------------------------------------
DGGG----------------------------D2D2D2D2D2--D2D2GGG-------D-------D---D-----------GGGGGGGG----------------------------------------------------------------------------
D--------GG----------------GGGGG||||||||||--||||----------D----D--D---D---------GGDDDDDDDDG---------------------------------------------------------------------------
D------------G-----D2-----------D2-------------D----------D----D--D---D-D----GGGDDDDDDDDDDDGG-------------------------------------------------------------------------
D-----D-----GD-----||-----------||-------------DGG--GGGGGGGGGGGGGGGGGGGGGGGGGDDDDDDDDDDDDDDDDGGG-G---GGG-----------DD-------------------------------------------------
D---D2D-----D2-----D2-----------D2--GGGGGGGGGGGGD2--D2D2D2D2D2D-----D2D2D2D2D2D2D2D2D2D2D2D2D2D2-D2--DDD--------------------------------------------------------------
GGGG||DDGGGG||GGGGG||GGGGGGGGGGG||-------------D||--||||||||||------||||||||||||||||||||||||||||-||--DDD------D-------------------GGGG--------------------------------
D2D2D2D2D2D2D2D2D2D2D2D2D2----D2D2-------------DD2------------------D2D2D2D2D2D2D2D2D2D2D2D2D2D2-D2--DDD------D--------------------DD2--------------------------------
||||||||||||||||||||||||||----||||GG-GG--G--G--G||-------------GGGGG||||||||||||||||||||||||||||-||--DDD-----DD---------------------||--------------------------------
D2D2D2D2D2D2D2D2D2D2D2D2D2--D2D2D2----------------------GGGGGGGDD2D2D2D2D2D2D2D2D2D2D2D2D2D2D2D2-D2--DDD----DDD------GGGG---------------------------------------------
||||||||||||||||||||||||||--||||||GGGG---------------GGGDDDDDDDD||||||||||||||||||||||||||||||||-||--DDD---DDDD-------------------------------------------------------
P2
3-19-"copper-coin"
14-19-"silver-coin"
24-28-"silver-coin"
21-65-"copper-coin"
3-90-"gold-coin"
3-31-"copper-coin"
12-8-"copper-coin"
20-1-"food-banana"
5-38-"food-pear"
2-42-"food-banana"
23-41-"food-banana"
23-44-"food-pear"
24-29-"food-banana"
25-53-"food-pepper"
1-19-"food-banana"
19-102-"food-blueberry"
23-108-"food-banana"
24-119-"food-blueberry"
21-132-"food-banana"
10-124-"food-orange"