25
34
P1
DDDDDDDDDDDDDDDDDDDDDDDDDDDDDDDDDD
D-D-D---D--D--D--DD--D----------D2
D-D-----D-----D---D--D----------||
D--------------------D--------GGD2
D--------------------D----------||
D-----F--------------DGG--------D2
D--------------------D----------||
D-----------GGGG----D2--------GGD2
DGG------G----------------------||
D--------D-----------D----------D2
D----GGG-D--------G--D-------GGG||
D--------D--------D--D----------D2
D--------D------GGD--D----------||
D-------GDGG------D2D2------GGGGD2
D-----------------||||----------||
DGGG----------------------------D2
D--------GG----------------GGGGG||
D------------G-----D2-----------D2
D-----D-----GD-----||-----------||
D---D2D-----D2-----D2-----------D2
GGGG||DDGGGG||GGGGG||GGGGGGGGGGG||
D2D2D2D2D2D2D2D2D2D2D2D2D2D2D2D2D2
||||||||||||||||||||||||||||||||||
D2D2D2D2D2D2D2D2D2D2D2D2D2D2D2D2D2
||||||||||||||||||||||||||||||||||