27
166
P1
---F------------------------------------------------------------------------------------------------------------------------------------------------------------------
----------------------------------------------------------------------------------------------------------------------------------------------------------------------
DDDDDDDDDDDDDDDDDDDDDDDDDDDDDDDDDD-------------D----------------------------------------------------------------------------------------------------------------------
D-D-D---D--D--D--DD--D----------D2--------G----D----------------------------------------------------------------------------------------------------------------------
D-D-----D-----D---D--D----------||-------------DGGGGG-----------------------------------------------------------------------------------------------------------------
D--------------------D--------GGD2-------------D------------------------------------GGGGGGGGGGGGGG--------------------------------------------------------------------
D--------------------D----------||----G--------D----------GGGGGGG--------------------DD2D2D2D2DD----------------------------------------------------------------------
D--------------------DGG-----------------------D-----------DDDDD----------------------||||||||------------------------------------------------------------------------
D--------------------D-----------------------GGD------------DD-------------------------DD--D--------------------------------------------------------------------------
D-----------GGGG----D2--------GGD2-------------D-------------D--------------------------D-----------------------------------------------------------------------------
DGG------G----------------------||------------------------------------------------------------------------------------------------------------------------------------
D--------D-----------D----------D2------------------------------------------------------------------------------------------------------------------------------------
D----GGG-D--------G--D-------GGG||---------GGGGD------------------D---------------------------------------------------------------------------------------------------
D--------D--------D--D----------D2-------------D------------------D---------------------------------------------------------------------------------------------------
D--------D------GGD--D----------||-------------D------------------D---------------------------------------------------------------------------------------------------
D-------GDGG------D2D2------GGGGD2-------------D------------------D---D-----------------------------------------------------------------------------------------------
D-----------------||||----------||-------------D----------D-------D---D-----------------------------------------------------------------------------------------------
DGGG----------------------------D2D2D2D2D2--D2D2GGG-------D-------D---D-----------GGGGGGGG----------------------------------------------------------------------------
D--------GG----------------GGGGG||||||||||--||||----------D----D--D---D---------GGDDDDDDDDG---------------------------------------------------------------------------
D------------G-----D2-----------D2-------------D----------D----D--D---D-D----GGGDDDDDDDDDDDGG-------------------------------------------------------------------------
D-----D-----GD-----||-----------||-------------DGG--GGGGGGGGGGGGGGGGGGGGGGGGGDDDDDDDDDDDDDDDDGGG-G---GGG--------------------------------------------------------------
D---D2D-----D2-----D2-----------D2--GGGGGGGGGGGGD2--D2D2D2D2D2D-----D2D2D2D2D2D2D2D2D2D2D2D2D2D2-D2--DDD--------------------------------------------------------------
GGGG||DDGGGG||GGGGG||GGGGGGGGGGG||-------------D||--||||||||||------||||||||||||||||||||||||||||-||--DDD--------------------------------------------------------------
D2D2D2D2D2D2D2D2D2D2D2D2D2----D2D2-------------DD2------------------D2D2D2D2D2D2D2D2D2D2D2D2D2D2-D2--DDD--------------------------------------------------------------
||||||||||||||||||||||||||----||||GG-GG--G--G--G||------------GGGGGG||||||||||||||||||||||||||||-||--DDD--------------------------------------------------------------
D2D2D2D2D2D2D2D2D2D2D2D2D2--D2D2D2----------------------GGGGGGD2D2D2D2D2D2D2D2D2D2D2D2D2D2D2D2D2-D2--DDD--------------------------------------------------------------
||||||||||||||||||||||||||--||||||GGGG---------------GGGDDDDDD||||||||||||||||||||||||||||||||||-||--DDD--------------------------------------------------------------