27
166
P1
---------------------------------------------------------------------GGG----------------------------------------------------------------------------------------------
---------------------------------------------------------------------DDD----------------------------------------------------------------------------------------------
DDDDDDDDDDDDDDDDDDDDDDDDDDDDDDDDDD-------------D------------F--------DDD------------------------------GGGGGGGGGGGG----------------------------------------------------
D-D-D---D--D--D--DD--D----------D2--------G----D-------------------------------------------------------DDD2D2D2D------------------------------------------------------
D-D-----D-----D---D--D----------||-------------DGGGGG----------------------------------------------------||||||----------------------------------G---G----------------
D--------------------D--------GGD2-------------D------------------------------------GGGGGGGGGGGGGG---------DD-----------------------------------GDGGGDGPpGGGGGG-------
D--------------------D----------||----G--------D----------GGGGGGG--------------------DD2D2D2D2DD-------------------------------------------------DDDDDD--DDDDD--------
D--------------------DGG-----------------------D-----------DDDDD----------------------||||||||----------------------------------------------------D--------D----------
D--------------------D-----------------------GGD------------DD-------------------------DD--D------------------------------------------------------D--------D----------
D-----------GGGG----D2--------GGD2-------------D-------------D--------------------------D-------------------------DDDD-----------------------------DDDD--DD-----------
DGG------G----------------------||-------------Kh---------------------------------------S--------------------------DD----------------------------------DD-------------
D--------D-----------D----------D2---------------------------------------------------------------------------------------------------S--S-----------------------------
DGGPpGGG-D--------G--D-------GGG||---------GGGGD------------------D------------------------------------------------------------------GPpG-----------------------------
D--------D--------D--D----------D2-------------D------------------D---------------------------------------------------------------------------------------------------
D--------D------GGD--D----------||-------------D------------------D---------------------------------------------------------G-----------------------------------------
D-------GDGG------D2D2------GGGGD2-------------D------------------D---D----------------------------------------GG-----------------------------------------------------
D-----------------||||----------||--S-S--------D----------D-------D---D-----------------------------------------------------------------------------------------------
DGGG----------------------------D2D2D2D2D2--D2D2GGG-------D-------D---D-----------GGGGGGGG----------------------------------------------------------------------------
D--------GG----------------GGGGG||||||||||--||||----------D----D--D---D---------GGDDDDDDDDG---------------------------------------------------------------------------
D------------G-----D2-----------D2-------------D----------D----D--D---D-DSSSSGGGDDDDDDDDDDDGG-------------------------------------------------------------------------
D-----D-----GD-----||-----------||-------------DGG--GGGGGGGGGGGGGGGGGGGGGGGGGDDDDDDDDDDDDDDDDGGG-G---GGG-----------DD-------------------------------------------------
D---D2D-----D2-----D2-----------D2--GGGGGGGGGGGGD2--D2D2D2D2D2D-----D2D2D2D2D2D2--D2D2D2D2D2D2D2-D2--DDD--------------------------------------------------------------
GGAG||DDGGGG||GGGGG||GGGGGGGGGGG||-------------D||--||||||||||------||||||||||||--||||||||||||||-||--DDD------D-------------------GGGG--------------------------------
D2D2D2D2D2D2D2D2D2D2D2D2D2----D2D2-------------DD2------------------D2D2D2D2D2----D2D2D2D2D2D2D2-D2--DDD------D--------------------DD2--------------------------------
||||||||||||||||||||||||||----||||GG-GG--G--G--G||--------------GGGG||||||||||----||||||||||||||-||--DDD-----DD---------------------||--------------GGGGGGGGGGGGGGGGGG
D2D2D2D2D2D2D2D2D2D2D2D2D2-SD2D2D2----------------------GGGGGGGGD2D2D2D2D2D2--------D2D2D2D2D2D2-D2--DDD----DDD------GGGG---------------------------D2D2D2D2D2D2D2D2D2
||||||||||||||||||||||||||-S||||||GGGG---------------GGGDDDDDDDD||||||||||||--------||||||||||||-||--DDD---DDDD-------------------------------------||||||||||||||||||
P2
3-19-"coin-copper"
14-19-"coin-silver"
24-28-"coin-silver"
21-65-"coin-copper"
3-90-"coin-gold"
3-31-"coin-copper"
12-8-"coin-copper"
20-1-"food-banana"
5-38-"food-pear"
2-42-"food-banana"
23-41-"food-banana"
23-44-"food-pear"
24-29-"food-banana"
25-53-"food-pepper"
1-19-"food-banana"
19-102-"food-blueberry"
23-108-"food-banana"
24-119-"food-blueberry"
21-132-"food-banana"
10-124-"food-orange"
21-133-"key-hope"
P3
10-44-"bee"
10-16-"bee"
20-34-"bee"
15-76-"bee"
26-80-"bee"
6-61-"snail"
0-70-"snail"
17-38-"snail"
13-85-"butterfly"
4-81-"butterfly"
21-25-"crab"
23-151-"crab"
1-105-"crab"
17-29-"crab"
endmap



quando buscar uma posição no mapa
subtraia 4 da linha e 2 da coluna.

A = altar
G = grama
D = dirt
S = spike
Pp = plataform
K(h|r|p|c|w) = gate
|- = ignore
